rrrrr111
QrQQr111
QrQQr111
rrrrr222
QrQQr222
QrQQr222
rrrrr333
QrQQr555
QrQQr555
rrrrrrrr
44444666
44444666