rrrrrrr111
rQrQQrr111
rQrQQrr111
rrrrrrr222
rQrQQrr222
rQrQQrr222
rrrrrrr333
rQrQQrr555
rQrQQrr555
rrrrrrrrrr
rrrrrrrrrr
4444446666
4444446666