rrrrr111
QrQQr111
QrQQr111
rrrrr222
QrQQr222
QrQQr222
rrrrr333
44444333
44444333