XXXXX000X000X000XXXXX
XXXXX000X000X000XXXXX
XXXXX000X000X000XXXXX
XXXXX000X000X000XXXXX
XXXXYrMrYrMrYrMrYXXXX
0000rXXXXXrrrrrrr0000
0000MrQrQrQrQrQrM0000
0000rrrrrrrrrrrrr0000
XXXXYrQrQrQrQrQrYXXXX
0000rrrrrrrrrrrrr0000
0000MrQrQrQrQrQrM0000
0000rrrrrrrrrrrrr0000
XXXXYrQrQrQrQrQrYXXXX
0000rrrrrrrrrrrrr0000
0000MrQrQrQrQrQrM0000
0000rrrrrrrrrrrrr0000
XXXXYrMrYrMrYrMrYXXXX
XXXXX000X000X000XXXXX
XXXXX000X000X000XXXXX
XXXXX000X000X000XXXXX
XXXXX000X000X000XXXXX