XXXXX000X000X000XXXXX
XXXXX000X000X000XXXXX
XXXXX000X000X000XXXXX
XXXXX000X000X000XXXXX
XXXXArMrArMrArMrAXXXX
0000rXXXXXrrrrrrr0000
0000MrQrQrQrQrQrM0000
0000rrrrrrrrrrrrr0000
XXXXArQrQrQrQrQrAXXXX
0000rrrrrrrrrrrrr0000
0000MrQrQrQrQrQrM0000
0000rrrrrrrrrrrrr0000
XXXXArQrQrQrQrQrAXXXX
0000rrrrrrrrrrrrr0000
0000MrQrQrQrQrQrM0000
0000rrrrrrrrrrrrr0000
XXXXArMrArMrArMrAXXXX
XXXXX000X000X000XXXXX
XXXXX000X000X000XXXXX
XXXXX000X000X000XXXXX
XXXXX000X000X000XXXXX