rrrrrrrrrrrrrrrrrrrrrrrrrrrrrrrrrrrrrrrrrrrrrrrrrrrrrrrrrrrrrrrrrrrrrrrrrrrrrrrr111
rQQrQQrQQrQQrQQrQQrQQrQQrQQrQQrQQrQQrQQrQQrQQrQQrQQrQQrQQrQQrQQrQQrQQrQQrQQrQQrQ111
rQArQArQArQArQArQArQArQArQArQArQArQArQArQArQArQArQArQArQArQArQArQArQArQArQArQArQ111
rrrrrrrrrrrrrrrrrrrrrrrrrrrrrrrrrrrrrrrrrrrrrrrrrrrrrrrrrrrrrrrrrrrrrrrrrrrrrrrr222
rQQrQQrQQrQQrQQrQQrQQrQQrQQrQQrQQrQQrQQrQQrQQrQQrQQrQQrQQrQQrQQrQQrQQrQQrQQrQQrQ222
rQArQArQArQArQArQArQArQArQArQArQArQArQArQArQArQArQArQArQArQArQArQArQArQArQArQArQ222
rrrrrrrrrrrrrrrrrrrrrrrrrrrrrrrrrrrrrrrrrrrrrrrrrrrrrrrrrrrrrrrrrrrrrrrrrrrrrrrr333
rQQrQQrQQrQQrQQrQQrQQrQQrQQrQQrQQrQQrQQrQQrQQrQQrQQrQQrQQrQQrQQrQQrQQrQQrQQrQQrQ333
rQArQArQArQArQArQArQArQArQArQArQArQArQArQArQArQArQArQArQArQArQArQArQArQArQArQArQ333
rrrrrrrrrrrrrrrrrrrrrrrrrrrrrrrrrrrrrrrrrrrrrrrrrrrrrrrrrrrrrrrrrrrrrrrrrrrrrrrr444
rQQrQQrQQrQQrQQrQQrQQrQQrQQrQQrQQrQQrQQrQQrQQrQQrQQrQQrQQrQQrQQrQQrQQrQQrQQrQQrQ444
rQArQArQArQArQArQArQArQArQArQArQArQArQArQArQArQArQArQArQArQArQArQArQArQArQArQArQ444
rrrrrrrrrrrrrrrrrrrrrrrrrrrrrrrrrrrrrrrrrrrrrrrrrrrrrrrrrrrrrrrrrrrrrrrrrrrrrrrr555
rQQrQQrQQrQQrQQrQQrQQrQQrQQrQQrQQrQQrQQrQQrQQrQQrQQrQQrQQrQQrQQrQQrQQrQQrQQrQQrQ555
rQArQArQArQArQArQArQArQArQArQArQArQArQArQArQArQArQArQArQArQArQArQArQArQArQArQArQ555
rrrrrrrrrrrrrrrrrrrrrrrrrrrrrrrrrrrrrrrrrrrrrrrrrrrrrrrrrrrrrrrrrrrrrrrrrrrrrrrr666
rQQrQQrQQrQQrQQrQQrQQrQQrQQrQQrQQrQQrQQrQQrQQrQQrQQrQQrQQrQQrQQrQQrQQrQQrQQrQQrQ666
rQArQArQArQArQArQArQArQArQArQArQArQArQArQArQArQArQArQArQArQArQArQArQArQArQArQArQ666
rrrrrrrrrrrrrrrrrrrrrrrrrrrrrrrrrrrrrrrrrrrrrrrrrrrrrrrrrrrrrrrrrrrrrrrrrrrrrrrr777
rQQrQQrQQrQQrQQrQQrQQrQQrQQrQQrQQrQQrQQrQQrQQrQQrQQrQQrQQrQQrQQrQQrQQrQQrQQrQQrQ777
rQArQArQArQArQArQArQArQArQArQArQArQArQArQArQArQArQArQArQArQArQArQArQArQArQArQArQ777
rrrrrrrrrrrrrrrrrrrrrrrrrrrrrrrrrrrrrrrrrrrrrrrrrrrrrrrrrrrrrrrrrrrrrrrrrrrrrrrr888
rQQrQQrQQrQQrQQrQQrQQrQQrQQrQQrQQrQQrQQrQQrQQrQQrQQrQQrQQrQQrQQrQQrQQrQQrQQrQQrQ888
rQArQArQArQArQArQArQArQArQArQArQArQArQArQArQArQArQArQArQArQArQArQArQArQArQArQArQ888
rrrrrrrrrrrrrrrrrrrrrrrrrrrrrrrrrrrrrrrrrrrrrrrrrrrrrrrrrrrrrrrrrrrrrrrrrrrrrrrr999
rQQrQQrQQrQQrQQrQQrQQrQQrQQrQQrQQrQQrQQrQQrQQrQQrQQrQQrQQrQQrQQrQQrQQrQQrQQrQQrQ999
rQArQArQArQArQArQArQArQArQArQArQArQArQArQArQArQArQArQArQArQArQArQArQArQArQArQArQ999
rrrrrrrrrrrrrrrrrrrrrrrrrrrrrrrrrrrrrrrrrrrrrrrrrrrrrrrrrrrrrrrrrrrrrrrrrrrrrrrr000
rQQrQQrQQrQQrQQrQQrQQrQQrQQrQQrQQrQQrQQrQQrQQrQQrQQrQQrQQrQQrQQrQQrQQrQQrQQrQQrQ000
rQArQArQArQArQArQArQArQArQArQArQArQArQArQArQArQArQArQArQArQArQArQArQArQArQArQArQ000
rrrrrrrrrrrrrrrrrrrrrrrrrrrrrrrrrrrrrrrrrrrrrrrrrrrrrrrrrrrrrrrrrrrrrrrrrrrrrrrrrrr
rQQrQQrQQrQQrQQrQQrQQrQQrQQrQQrQQrQQrQQrQQrQQrQQrQQrQQrQQrQQrQQrQQrQQrQQrQQrQQrQrrr
rQArQArQArQArQArQArQArQArQArQArQArQArQArQArQArQArQArQArQArQArQArQArQArQArQArQArQrrr
rrrrrrrrrrrrrrrrrrrrrrrrrrrrrrrrrrrrrrrrrrrrrrrrrrrrrrrrrrrrrrrrrrrrrrrrrrrrrrrrrrr
rQQrQQrQQrQQrQQrQQrQQrQQrQQrQQrQQrQQrQQrQQrQQrQQrQQrQQrQQrQQrQQrQQrQQrQQrQQrQQrQrrr
rQArQArQArQArQArQArQArQArQArQArQArQArQArQArQArQArQArQArQArQArQArQArQArQArQArQArQrrr
rrrrrrrrrrrrrrrrrrrrrrrrrrrrrrrrrrrrrrrrrrrrrrrrrrrrrrrrrrrrrrrrrrrrrrrrrrrrrrrrrrr
rQQrQQrQQrQQrQQrQQrQQrQQrQQrQQrQQrQQrQQrQQrQQrQQrQQrQQrQQrQQrQQrQQrQQrQQrQQrQQrQrrr
rQArQArQArQArQArQArQArQArQArQArQArQArQArQArQArQArQArQArQArQArQArQArQArQArQArQArQrrr
rrrrrrrrrrrrrrrrrrrrrrrrrrrrrrrrrrrrrrrrrrrrrrrrrrrrrrrrrrrrrrrrrrrrrrrrrrrrrrrrrrr
rQQrQQrQQrQQrQQrQQrQQrQQrQQrQQrQQrQQrQQrQQrQQrQQrQQrQQrQQrQQrQQrQQrQQrQQrQQrQQrQrrr
rQArQArQArQArQArQArQArQArQArQArQArQArQArQArQArQArQArQArQArQArQArQArQArQArQArQArQrrr
rrrrrrrrrrrrrrrrrrrrrrrrrrrrrrrrrrrrrrrrrrrrrrrrrrrrrrrrrrrrrrrrrrrrrrrrrrrrrrrrrrr
rQQrQQrQQrQQrQQrQQrQQrQQrQQrQQrQQrQQrQQrQQrQQrQQrQQrQQrQQrQQrQQrQQrQQrQQrQQrQQrQrrr
rQArQArQArQArQArQArQArQArQArQArQArQArQArQArQArQArQArQArQArQArQArQArQArQArQArQArQrrr
rrrrrrrrrrrrrrrrrrrrrrrrrrrrrrrrrrrrrrrrrrrrrrrrrrrrrrrrrrrrrrrrrrrrrrrrrrrrrrrrrrr
rQQrQQrQQrQQrQQrQQrQQrQQrQQrQQrQQrQQrQQrQQrQQrQQrQQrQQrQQrQQrQQrQQrQQrQQrQQrQQrQrrr
rQArQArQArQArQArQArQArQArQArQArQArQArQArQArQArQArQArQArQArQArQArQArQArQArQArQArQrrr
rrrrrrrrrrrrrrrrrrrrrrrrrrrrrrrrrrrrrrrrrrrrrrrrrrrrrrrrrrrrrrrrrrrrrrrrrrrrrrrrrrr
rQQrQQrQQrQQrQQrQQrQQrQQrQQrQQrQQrQQrQQrQQrQQrQQrQQrQQrQQrQQrQQrQQrQQrQQrQQrQQrQrrr
rQArQArQArQArQArQArQArQArQArQArQArQArQArQArQArQArQArQArQArQArQArQArQArQArQArQArQrrr
rrrrrrrrrrrrrrrrrrrrrrrrrrrrrrrrrrrrrrrrrrrrrrrrrrrrrrrrrrrrrrrrrrrrrrrrrrrrrrrrrrr
rQQrQQrQQrQQrQQrQQrQQrQQrQQrQQrQQrQQrQQrQQrQQrQQrQQrQQrQQrQQrQQrQQrQQrQQrQQrQQrQrrr
rQArQArQArQArQArQArQArQArQArQArQArQArQArQArQArQArQArQArQArQArQArQArQArQArQArQArQrrr
rrrrrrrrrrrrrrrrrrrrrrrrrrrrrrrrrrrrrrrrrrrrrrrrrrrrrrrrrrrrrrrrrrrrrrrrrrrrrrrrrrr
rQQrQQrQQrQQrQQrQQrQQrQQrQQrQQrQQrQQrQQrQQrQQrQQrQQrQQrQQrQQrQQrQQrQQrQQrQQrQQrQrrr
rQArQArQArQArQArQArQArQArQArQArQArQArQArQArQArQArQArQArQArQArQArQArQArQArQArQArQrrr
rrrrrrrrrrrrrrrrrrrrrrrrrrrrrrrrrrrrrrrrrrrrrrrrrrrrrrrrrrrrrrrrrrrrrrrrrrrrrrrrrrr
rQQrQQrQQrQQrQQrQQrQQrQQrQQrQQrQQrQQrQQrQQrQQrQQrQQrQQrQQrQQrQQrQQrQQrQQrQQrQQrQrrr
rQArQArQArQArQArQArQArQArQArQArQArQArQArQArQArQArQArQArQArQArQArQArQArQArQArQArQrrr
rrrrrrrrrrrrrrrrrrrrrrrrrrrrrrrrrrrrrrrrrrrrrrrrrrrrrrrrrrrrrrrrrrrrrrrrrrrrrrrrrrr
rQQrQQrQQrQQrQQrQQrQQrQQrQQrQQrQQrQQrQQrQQrQQrQQrQQrQQrQQrQQrQQrQQrQQrQQrQQrQQrQrrr
rQArQArQArQArQArQArQArQArQArQArQArQArQArQArQArQArQArQArQArQArQArQArQArQArQArQArQrrr
rrrrrrrrrrrrrrrrrrrrrrrrrrrrrrrrrrrrrrrrrrrrrrrrrrrrrrrrrrrrrrrrrrrrrrrrrrrrrrrrrrr
rQQrQQrQQrQQrQQrQQrQQrQQrQQrQQrQQrQQrQQrQQrQQrQQrQQrQQrQQrQQrQQrQQrQQrQQrQQrQQrQrrr
rQArQArQArQArQArQArQArQArQArQArQArQArQArQArQArQArQArQArQArQArQArQArQArQArQArQArQrrr
rrrrrrrrrrrrrrrrrrrrrrrrrrrrrrrrrrrrrrrrrrrrrrrrrrrrrrrrrrrrrrrrrrrrrrrrrrrrrrrrrrr
rQQrQQrQQrQQrQQrQQrQQrQQrQQrQQrQQrQQrQQrQQrQQrQQrQQrQQrQQrQQrQQrQQrQQrQQrQQrQQrQrrr
rQArQArQArQArQArQArQArQArQArQArQArQArQArQArQArQArQArQArQArQArQArQArQArQArQArQArQrrr
rrrrrrrrrrrrrrrrrrrrrrrrrrrrrrrrrrrrrrrrrrrrrrrrrrrrrrrrrrrrrrrrrrrrrrrrrrrrrrrrrrr
rQQrQQrQQrQQrQQrQQrQQrQQrQQrQQrQQrQQrQQrQQrQQrQQrQQrQQrQQrQQrQQrQQrQQrQQrQQrQQrQrrr
rQArQArQArQArQArQArQArQArQArQArQArQArQArQArQArQArQArQArQArQArQArQArQArQArQArQArQrrr
rrrrrrrrrrrrrrrrrrrrrrrrrrrrrrrrrrrrrrrrrrrrrrrrrrrrrrrrrrrrrrrrrrrrrrrrrrrrrrrrrrr
rQQrQQrQQrQQrQQrQQrQQrQQrQQrQQrQQrQQrQQrQQrQQrQQrQQrQQrQQrQQrQQrQQrQQrQQrQQrQQrQrrr
rQArQArQArQArQArQArQArQArQArQArQArQArQArQArQArQArQArQArQArQArQArQArQArQArQArQArQrrr
rrrrrrrrrrrrrrrrrrrrrrrrrrrrrrrrrrrrrrrrrrrrrrrrrrrrrrrrrrrrrrrrrrrrrrrrrrrrrrrrrrr
rQQrQQrQQrQQrQQrQQrQQrQQrQQrQQrQQrQQrQQrQQrQQrQQrQQrQQrQQrQQrQQrQQrQQrQQrQQrQQrQrrr
rQArQArQArQArQArQArQArQArQArQArQArQArQArQArQArQArQArQArQArQArQArQArQArQArQArQArQrrr
rrrrrrrrrrrrrrrrrrrrrrrrrrrrrrrrrrrrrrrrrrrrrrrrrrrrrrrrrrrrrrrrrrrrrrrrrrrrrrrrrrr
rQQrQQrQQrQQrQQrQQrQQrQQrQQrQQrQQrQQrQQrQQrQQrQQrQQrQQrQQrQQrQQrQQrQQrQQrQQrQQrQrrr
